[Language]
info=简体中文(&C)
Codepage=936

;874 泰语
;932 日语 
;936 中文（简体）
;949 朝鲜语 
;950 中文（台湾和香港繁体）
;1200 Unicode 
;1250 东欧语言
;1251 西里尔语 
;1252 美国和西欧语言
;1253 希腊语 
;1254 土耳其语 
;1255 希伯来语 
;1256 阿拉伯语 
;1257 波罗的语 

[Dialog]
OK=确定
Cancel=取消
Unregistered=未注册
Finished! Do you wish to run?=完成! 你希望运行吗?
Basic colors=基本颜色
More colors...=更多颜色...
Relative_Dlg=你选的文件和你的文档不能形成相对路径，你想复制文件到文档文件夹中吗?
Save changes to project %s?=项目%s已改变，是否保存? 
Save changes to %s?=文件%s已改变，是否保存?
Delete selected node?=删除所选节点? 
Delete %d nodes?=删除%d个节点? 
Delete node=删除节点
Delete selected Index?=删除选择的索引吗?
Delete Index=删除索引
Select Directory=选择路径
Thank you for registering QuickCHM!=感谢你注册QuickCHM! 
RegAsk=本软件没有时间的限制。未注册用户不能编译大于20个节点的项目。如果你喜欢这款软件，请注册软件。大陆地区注册费RMB20元



[Caption]
Contents=目录
Index=索引
Design=编辑
Source=源文件
Preview=预览
Text=纯文本
Move up=上移 
Move down=下移 
Move left=左移
Move right=右移
Delete topic=删除主题
Delete index=删除索引
New=新建
Open=打开
Save=保存
Compile=编译
&Print=打印
Undo=撤消
Redo=重做
cut=剪切
Copy=复制
paste=粘贴
delete=删除
Find=查找
Help=帮助
Show Details=显示细节
Show Border=显示无边框表格
Bold=粗体
Italic=斜体
Underline=下划线
Number list=有序列表
Bullet list=无序列表
Decrease Indent=右缩进
Increase Indent=左缩进
Align Left=左对齐
Align Center=居中
Align Right=右对齐
Font Color=字体颜色
Back Color=字体的背景颜色
Link=链接
Line=水平直线
Return=换行符
Html=网页代码

Insert Table=插入表格
Insert Row=插入行
Insert Column=插入列
Insert Cell=插入单元格
delete Rows=删除行
delete Columns=删除列
delete cells=删除单元格
Merge cells=合并单元格
Split Cell=拆分单元格
Save Webpage=保存网页
Lock=锁定
Page Properties=页面属性
Background=背景图片
Fix=固定
BackColor=背景
TextColor=文本
LinkColor=链接
VlinkColor=已访问的链接
ClinkColor=当前链接
Insert image=插入图片
Image=图片
Alt=替代文字
Width=宽度
Height=高度
Specify size=指定大小
Horizontal=水平间隔
Vertical=垂直间隔
Border=边框宽度
Insert Table=插入表格
Row=行
Col=列
Border size=边框尺寸
Color=颜色
Cellpadding=单元格边距
CellSpacing=单元格间隔
Table Properties=表格属性
align=位置
Specify width=指定宽度
Specify Height=指定高度
LightColor=亮边颜色
DarkColor=暗边颜色
UseImage=使用图片
Browser=浏览

CHM Wizard=CHM向导
Project Folder=项目文件夹
Project Name=项目名称
File Filter=文件过滤
With Contents=有目录
With Index=有索引
&Help=帮助(&H)
< &Back=< 上一步(&B)
&Next >=下一步(&N) >
&Cancel=取消(&C)
&Finish=完成(&F)
Editor=编辑器
Add Editor=添加编辑器
Name=名称
Command=命令
New Topic=新建主题
Caption=标题
File/Url=文件/链接
Add Index=添加索引
Change Icon=更改图标
include sub node=包括子节点
Date/Time=日期/时间
Decompile=反编译
In=输入
Out=输出
Filelist=文件列表
Filename=文件名
Add=增加
Remove=删除
Insert html=插入代码
Properties=属性
Jump=跳转
Jump to=跳转到
Add folder=添加文件夹 
Include sub folder=包括子文件夹
To sub node=到子节点
Icon=图标
Register=注册
User name=用户名
Key=密钥
Buy Now=购买
Continue=继续 
Stop=停止
Test=测试
Close=关闭
Preference=参数
Read Topic=读取主题 
Read html tile=读网页标题(title)
Read filename=读文件名
Webpage Charset=网页字符
Default=默认
Files=文件
Buttons=按钮
Panel=面板
Position=位置
Normal=普通
Extended=扩展
Other=其他
Title=标题
Home=主页
Jump 1=自定义1
Jump 2=自定义2
Language=语言
Hide/show=隐藏/显示
Back=后退
Forward=前进
Refresh=刷新
Font=字体
Print=打印
Options=选项
Locate=定位
Hide the Caption of buttons=隐藏工具栏标题
PanelWidth=面板宽度
Default Icon=默认图标
Tabs position=tabs的位置
Default tab=默认tab
Open with navigation panel closed=打开时面板关闭
Auto sync=同步
Automatically show/hide navigation panel=自动显示/隐藏面板


Tabs=跳格(Tabs)
Search=搜索
Advanced=高级
Favorites=书签
buttons at Up=按钮向上
Buttons at Left=按钮向左
Buttons at down=按钮向下

Contents tree=目录树
ShowSelection=显示选择
Track=轨迹
Show[+][-]=显示[+][-]
Have link effect=有链接效果
Show Lines=显示虚线
Show Root=显示根
Expand=展开
Row select=行选
Left=左
Top=顶
Record position after used=记录位置和大小
Normal styles=普通样式
Minimize box=最小化按钮
Maximize box=最大化按钮
Thick frame=厚框架
System menu=系统菜单
Horizontal scroll=水平滚动条
Vertical scroll=垂直滚动条
Dlg frame=对话框框架
Border=边框
Maximize=最大化
Clip Child windows=有子窗口
Clip sibling windows=有同级窗口
Disabled=失效
Visible=可视
Minimize=最小化
Child windows=子窗口
Pop-up=弹出
Overlapped=迭交
No parent Notify=不通知父母
Topmost=始终最上
Accept files=接受文件
Transparent=透明
Tool windows=工具窗口
Client edge=客户区边框
Context help=上下文帮助
Right aligned text=右对齐文本
Right-to-left reading order=右到左阅读顺序
Left scroll bar=左滚动条
Control parent window=控制父窗口
Static edge=静态边框
Create a binary index=创建二进制索引
Create a binary Toc=创建二进制TOC
Create a CHI=创建CHI
Compile full-text search information=编译全文搜索信息
Support enhanced decompilation=支持增强反编译
Don't include folders in compiled file=编译文件中不保存目录信息
compile file=编译文件
content file=目录文件
index file=索引文件
Splash=闪屏
Splash image=闪屏图象
Time=时间
Second=秒

&File=文件(&F)
&New=新建(&N)
&Open=打开(&O)
&Reopen=最近打开(&R)
Clear &History=清除历史(&H)
&Close=关闭(&C)
&Save=保存(&S)
Save &As...=另存为(&A)
CHM &Wizard=CHM向导(&W)
Com&pile=编译(&P)
&DeCompile...=反编译(&D)
P&rint=打印(&I)
&Exit=退出(&E)
T&opics=主题(&O)
&Edit Topic=编辑(&E)
&New Topic=新建主题(&A)
&Import=导入(&I)
Add &Folder=添加文件夹(&F)
&Add Files=添加文件(&A)
Add &Sub Files=添加子文件(&S)
&Delete Topic=删除主题(&D)
&Expand All=展开所有(&X)
&Collapse All=紧缩所有(&L)
S&ort Select=所选节点排序(&S)
Sort A&ll=所有排序(&S)
Sort Selected &Items=所选节点排序(&I)
&Sort All items=所有排序(&S)
&Change Icon=更改图标(&C)
&Properties=属性(&P)
&Index=索引(&I)
&Edit Name=编辑(&E)
&Add Index=添加索引(&A)
&Delete Index=删除索引(&D)
&Edit=编辑(&E)
&Undo=撤消(&U)
&Redo=重做(&R)
Cu&t=剪切(&T)
&Copy=复制(&C)
&Paste=粘贴(&P)
&Delete=删除(&D)
Se&lect All=全选(&A)
&Find...=查找...(&F)
For&mat=格式(&M)
&Number List=有序列表(&N)
&Bullet List=无序列表(&B)
&Decrease Indent=右缩进(&D)
&Increase Indent=左缩进(&I)
Align &Left=左对齐(&L)
Align &Center=居中(&C)
Align &Right=右对齐(&R)
&Page Properties=页面属性(&P)
&Insert=插入(&N)
Lin&e=水平直线(&E)
&Return=换行符(&R)
&Link=链接(&L)
&Image=图象(&M)
&Html=网页代码(&H)
&Date=日期(&D)
&Table=表格(&T)
&Insert Table=插入表格(&I)
Insert &Row=插入行(&R)
Insert &Column=插入列(&C)
Insert Ce&ll=插入单元格(&L)
delete Ro&ws=删除行(&W)
delete Colum&ns=删除列(&N)
delete C&ells=删除单元格(&E)
&Merge cells=合并单元格(&M)
&Split Cell=拆分单元格(&S)
Table &Properties=表格属性(&P)
&View=查看(&V)
Show &Details=显示细节(&D)
Show &Border=显示无边框表格(&B)
File &List=文件列表(&L) 
O&ptions=选项(&P)
&Project Preference=项目选项(&P)
&Application Preference=系统选项(&S)
&Help=帮助(&H)
Help &Topic=帮助主题(&T)
Help &Index=帮助索引(&I)
&Register=注册(&R)
&About...=关于(&A)
Ab&solute=自由拖动(&S)
Editors &Set=编辑器设置(&S) 

Move / &Sibling=移动 / 同节点(&S)
Move / Child / &First=移动 / 子节点 / 最前(&F)
Move / Child / &Last=移动 / 子节点 / 最后(&L)
Copy / S&ibling=复制 / 同节点(&I)
Copy / Child / Fi&rst=复制 / 子节点 / 最前(&R)
Copy / Child / L&ast=复制 / 子节点 / 最后(&A)



&OK=确定(&O)
&Cancel=取消(&C)

General=常规
Entry &title=输入标题(&T)
&Files/URLs=文件/链接
&Image=图标
&Contents=目录
Include sub folder=包含子文件夹
Read html tile=读网页标题(title)

&Destination folder=目标文件夹(&D)
&Compiled help file=已编译得帮助文件(&C)



Select Html File=选择网页文件
Select Folder=选择文件夹
&Keyword=关键字(&K)
Compiled file=编译文件
Select=选择
&Title=标题(&T)
&Default=默认(&D)
&Home=主页(&H)
&Language=语言(&L)
Compiled=编译
Files &List=文件列表
File List=文件列表
Project=项目
Hide View=隐藏视图
Clear All=清空
Log=日志
